XXX....R
XXX.....
XXX.....
........
........